1111111111
1000000101
1010000101
1000100101
1000001101
10001000N1
1111111111