11111111111111
10010000000101
10000000000101
11111000000101
10010000001001
11000000000001
10001000010001
10100010000001
100010001000N1
11111111111111